13
13
XXXXX.XXXXXXX
X...X.......X
X.XXX.XXXXX.X
X.X...X.....X
X.X.XXX.XXXXX
X...X.......X
XXXXX.XXXXX.X
X.....X.....X
X.XXXXX.XXXXX
X.X.......X.X
X.XXXXXXX.X.X
X.......X...X
XXXXXXX.XXXXX