13
13
#####.#######
#...#.......#
#.###.#####.#
#.#...#.....#
#.#.###.#####
#...#.......#
#####.#####.#
#.....#.....#
#.#####.#####
#.#.......#.#
#.#######.#.#
#.......#...#
#######.#####